NO ./textures/bluestone.xpm
SO ./textures/greystone.xpm
WE ./textures/redbrick.xpm
EA ./textures/wood.xpm

F 255,255,255
C 0,0,0

111111
100101
101001
1100W1
111111
